name	mf
AARON	m
ABBEY	f
ABBIE	f
ABBY	f
ABDUL	m
ABE	m
ABEL	m
ABIGAIL	f
ABRAHAM	m
ABRAM	m
ADA	f
ADAH	f
ADALBERTO	m
ADALINE	f
ADAM	m
ADAN	m
ADDIE	f
ADELA	f
ADELAIDA	f
ADELAIDE	f
ADELE	f
ADELIA	f
ADELINA	f
ADELINE	f
ADELL	f
ADELLA	f
ADELLE	f
ADENA	f
ADINA	f
ADOLFO	m
ADOLPH	m
ADRIA	f
ADRIAN	m
ADRIANA	f
ADRIANE	f
ADRIANNA	f
ADRIANNE	f
ADRIEN	f
ADRIENE	f
ADRIENNE	f
AFTON	f
AGATHA	f
AGNES	f
AGNUS	f
AGRIPINA	f
AGUEDA	f
AGUSTIN	m
AGUSTINA	f
AHMAD	m
AHMED	m
AI	f
AIDA	f
AIDE	f
AIKO	f
AILEEN	f
AILENE	f
AIMEE	f
AISHA	f
AJA	f
AKIKO	f
AKILAH	f
AL	m
ALAINA	f
ALAINE	f
ALAN	m
ALANA	f
ALANE	f
ALANNA	f
ALAYNA	f
ALBA	f
ALBERT	m
ALBERTA	f
ALBERTHA	f
ALBERTINA	f
ALBERTINE	f
ALBERTO	m
ALBINA	f
ALDA	f
ALDEN	m
ALDO	m
ALEASE	f
ALEC	m
ALECIA	f
ALEEN	f
ALEIDA	f
ALEISHA	f
ALEJANDRA	f
ALEJANDRINA	f
ALEJANDRO	m
ALENA	f
ALENE	f
ALESHA	f
ALESHIA	f
ALESIA	f
ALESSANDRA	f
ALETA	f
ALETHA	f
ALETHEA	f
ALETHIA	f
ALEX	m
ALEXA	f
ALEXANDER	m
ALEXANDRA	f
ALEXANDRIA	f
ALEXIA	f
ALEXIS	f
ALFONSO	m
ALFONZO	m
ALFRED	m
ALFREDA	f
ALFREDIA	f
ALFREDO	m
ALI	m
ALIA	f
ALICA	f
ALICE	f
ALICIA	f
ALIDA	f
ALINA	f
ALINE	f
ALISA	f
ALISE	f
ALISHA	f
ALISHIA	f
ALISIA	f
ALISON	f
ALISSA	f
ALITA	f
ALIX	f
ALIZA	f
ALLA	f
ALLAN	m
ALLEEN	f
ALLEGRA	f
ALLEN	m
ALLENA	f
ALLENE	f
ALLIE	f
ALLINE	f
ALLISON	f
ALLYN	f
ALLYSON	f
ALMA	f
ALMEDA	f
ALMETA	f
ALONA	f
ALONSO	m
ALONZO	m
ALPHA	f
ALPHONSE	m
ALPHONSO	m
ALTA	f
ALTAGRACIA	f
ALTHA	f
ALTHEA	f
ALTON	m
ALVARO	m
ALVERA	f
ALVERTA	f
ALVIN	m
ALVINA	f
ALYCE	f
ALYCIA	f
ALYSA	f
ALYSE	f
ALYSHA	f
ALYSIA	f
ALYSON	f
ALYSSA	f
AMADA	f
AMADO	m
AMAL	f
AMALIA	f
AMANDA	f
AMBER	f
AMBERLY	f
AMBROSE	m
AMEE	f
AMELIA	f
AMERICA	f
AMI	f
AMIE	f
AMIEE	f
AMINA	f
AMIRA	f
AMMIE	f
AMOS	m
AMPARO	f
AMY	f
AN	f
ANA	f
ANABEL	f
ANALISA	f
ANAMARIA	f
ANASTACIA	f
ANASTASIA	f
ANDERA	f
ANDERSON	m
ANDRA	f
ANDRE	m
ANDREA	f
ANDREAS	m
ANDREE	f
ANDRES	m
ANDREW	m
ANDRIA	f
ANDY	m
ANETTE	f
ANGEL	m
ANGELA	f
ANGELE	f
ANGELENA	f
ANGELES	f
ANGELIA	f
ANGELIC	f
ANGELICA	f
ANGELIKA	f
ANGELINA	f
ANGELINE	f
ANGELIQUE	f
ANGELITA	f
ANGELLA	f
ANGELO	m
ANGELYN	f
ANGIE	f
ANGILA	f
ANGLA	f
ANGLE	f
ANGLEA	f
ANH	f
ANIBAL	m
ANIKA	f
ANISA	f
ANISHA	f
ANISSA	f
ANITA	f
ANITRA	f
ANJA	f
ANJANETTE	f
ANJELICA	f
ANN	f
ANNA	f
ANNABEL	f
ANNABELL	f
ANNABELLE	f
ANNALEE	f
ANNALISA	f
ANNAMAE	f
ANNAMARIA	f
ANNAMARIE	f
ANNE	f
ANNELIESE	f
ANNELLE	f
ANNEMARIE	f
ANNETT	f
ANNETTA	f
ANNETTE	f
ANNICE	f
ANNIE	f
ANNIKA	f
ANNIS	f
ANNITA	f
ANNMARIE	f
ANTHONY	m
ANTIONE	m
ANTIONETTE	f
ANTOINE	m
ANTOINETTE	f
ANTON	m
ANTONE	m
ANTONETTA	f
ANTONETTE	f
ANTONIA	f
ANTONIETTA	f
ANTONINA	f
ANTONIO	m
ANTONY	m
ANTWAN	m
ANYA	f
APOLONIA	f
APRIL	f
APRYL	f
ARA	f
ARACELI	f
ARACELIS	f
ARACELY	f
ARCELIA	f
ARCHIE	m
ARDATH	f
ARDELIA	f
ARDELL	f
ARDELLA	f
ARDELLE	f
ARDEN	m
ARDIS	f
ARDITH	f
ARETHA	f
ARGELIA	f
ARGENTINA	f
ARIANA	f
ARIANE	f
ARIANNA	f
ARIANNE	f
ARICA	f
ARIE	f
ARIELLE	f
ARLA	f
ARLEAN	f
ARLEEN	f
ARLEN	m
ARLENA	f
ARLENE	f
ARLETHA	f
ARLETTA	f
ARLETTE	f
ARLIE	m
ARLINDA	f
ARLINE	f
ARLYNE	f
ARMAND	m
ARMANDA	f
ARMANDINA	f
ARMANDO	m
ARMIDA	f
ARMINDA	f
ARNETTA	f
ARNETTE	f
ARNITA	f
ARNOLD	m
ARNOLDO	m
ARNULFO	m
ARON	m
ARRON	m
ART	m
ARTHUR	m
ARTIE	f
ARTURO	m
ARVILLA	f
ASA	m
ASHA	f
ASHANTI	f
ASHELY	f
ASHLEA	f
ASHLEE	f
ASHLEIGH	f
ASHLEY	f
ASHLI	f
ASHLIE	f
ASHLY	f
ASHLYN	f
ASHTON	f
ASIA	f
ASLEY	f
ASSUNTA	f
ASTRID	f
ASUNCION	f
ATHENA	f
AUBREY	m
AUDIE	f
AUDRA	f
AUDREA	f
AUDREY	f
AUDRIA	f
AUDRIE	f
AUDRY	f
AUGUST	m
AUGUSTA	f
AUGUSTINA	f
AUGUSTINE	m
AUGUSTUS	m
AUNDREA	f
AURA	f
AUREA	f
AURELIA	f
AURELIO	m
AURORA	f
AURORE	f
AUSTIN	m
AUTUMN	f
AVA	f
AVELINA	f
AVERY	m
AVIS	f
AVRIL	f
AWILDA	f
AYAKO	f
AYANA	f
AYANNA	f
AYESHA	f
AZALEE	f
AZUCENA	f
AZZIE	f
BABARA	f
BABETTE	f
BAILEY	f
BAMBI	f
BAO	f
BARABARA	f
BARB	f
BARBAR	f
BARBARA	f
BARBERA	f
BARBIE	f
BARBRA	f
BARI	f
BARNEY	m
BARRETT	m
BARRIE	f
BARRY	m
BART	m
BARTON	m
BASIL	m
BASILIA	f
BEA	f
BEATA	f
BEATRICE	f
BEATRIS	f
BEATRIZ	f
BEAU	m
BEAULAH	f
BEBE	f
BECKI	f
BECKIE	f
BECKY	f
BEE	f
BELEN	f
BELIA	f
BELINDA	f
BELKIS	f
BELL	f
BELLA	f
BELLE	f
BELVA	f
BEN	m
BENEDICT	m
BENITA	f
BENITO	m
BENJAMIN	m
BENNETT	m
BENNIE	m
BENNY	m
BENTON	m
BERENICE	f
BERNA	f
BERNADETTE	f
BERNADINE	f
BERNARD	m
BERNARDA	f
BERNARDINA	f
BERNARDINE	f
BERNARDO	m
BERNEICE	f
BERNETTA	f
BERNICE	f
BERNIE	m
BERNIECE	f
BERNITA	f
BERRY	m
BERT	m
BERTA	f
BERTHA	f
BERTIE	f
BERTRAM	m
BERYL	f
BESS	f
BESSIE	f
BETH	f
BETHANIE	f
BETHANN	f
BETHANY	f
BETHEL	f
BETSEY	f
BETSY	f
BETTE	f
BETTIE	f
BETTINA	f
BETTY	f
BETTYANN	f
BETTYE	f
BEULA	f
BEULAH	f
BEV	f
BEVERLEE	f
BEVERLEY	f
BEVERLY	f
BIANCA	f
BIBI	f
BILL	m
BILLI	f
BILLIE	f
BILLY	m
BILLYE	f
BIRDIE	f
BIRGIT	f
BLAINE	m
BLAKE	m
BLANCA	f
BLANCH	f
BLANCHE	f
BLONDELL	f
BLOSSOM	f
BLYTHE	f
BO	m
BOB	m
BOBBI	f
BOBBIE	f
BOBBY	m
BOBBYE	f
BOBETTE	f
BOK	f
BONG	f
BONITA	f
BONNIE	f
BONNY	f
BOOKER	m
BORIS	m
BOYCE	m
BOYD	m
BRAD	m
BRADFORD	m
BRADLEY	m
BRADLY	m
BRADY	m
BRAIN	m
BRANDA	f
BRANDE	f
BRANDEE	f
BRANDEN	m
BRANDI	f
BRANDIE	f
BRANDON	m
BRANDY	f
BRANT	m
BREANA	f
BREANN	f
BREANNA	f
BREANNE	f
BREE	f
BRENDA	f
BRENDAN	m
BRENDON	m
BRENNA	f
BRENT	m
BRENTON	m
BRET	m
BRETT	m
BRIAN	m
BRIANA	f
BRIANNA	f
BRIANNE	f
BRICE	m
BRIDGET	f
BRIDGETT	f
BRIDGETTE	f
BRIGETTE	f
BRIGID	f
BRIGIDA	f
BRIGITTE	f
BRINDA	f
BRITANY	f
BRITNEY	f
BRITNI	f
BRITTA	f
BRITTANEY	f
BRITTANI	f
BRITTANIE	f
BRITTANY	f
BRITTENY	f
BRITTNEY	f
BRITTNI	f
BRITTNY	f
BROCK	m
BRODERICK	m
BRONWYN	f
BROOK	f
BROOKE	f
BROOKS	m
BRUCE	m
BRUNA	f
BRUNILDA	f
BRUNO	m
BRYAN	m
BRYANNA	f
BRYANT	m
BRYCE	m
BRYNN	f
BRYON	m
BUCK	m
BUD	m
BUDDY	m
BUENA	f
BUFFY	f
BUFORD	m
BULA	f
BULAH	f
BUNNY	f
BURL	m
BURMA	f
BURT	m
BURTON	m
BUSTER	m
BYRON	m
CAITLIN	f
CAITLYN	f
CALANDRA	f
CALEB	m
CALISTA	f
CALLIE	f
CALVIN	m
CAMELIA	f
CAMELLIA	f
CAMERON	m
CAMI	f
CAMIE	f
CAMILA	f
CAMILLA	f
CAMILLE	f
CAMMIE	f
CAMMY	f
CANDACE	f
CANDANCE	f
CANDELARIA	f
CANDI	f
CANDICE	f
CANDIDA	f
CANDIE	f
CANDIS	f
CANDRA	f
CANDY	f
CANDYCE	f
CAPRICE	f
CARA	f
CAREN	f
CARI	f
CARIDAD	f
CARIE	f
CARIN	f
CARINA	f
CARISA	f
CARISSA	f
CARITA	f
CARL	m
CARLA	f
CARLEE	f
CARLEEN	f
CARLENA	f
CARLENE	f
CARLETTA	f
CARLEY	f
CARLI	f
CARLIE	f
CARLINE	f
CARLITA	f
CARLO	m
CARLOS	m
CARLOTA	f
CARLOTTA	f
CARLTON	m
CARLY	f
CARLYN	f
CARMA	f
CARMAN	f
CARMEL	f
CARMELA	f
CARMELIA	f
CARMELINA	f
CARMELITA	f
CARMELLA	f
CARMELO	m
CARMEN	f
CARMINA	f
CARMINE	m
CARMON	f
CAROL	f
CAROLA	f
CAROLANN	f
CAROLE	f
CAROLEE	f
CAROLIN	f
CAROLINA	f
CAROLINE	f
CAROLL	f
CAROLYN	f
CAROLYNE	f
CAROLYNN	f
CARON	f
CAROYLN	f
CARRI	f
CARRIE	f
CARROLL	m
CARRY	f
CARSON	m
CARTER	m
CARY	m
CARYL	f
CARYLON	f
CARYN	f
CASANDRA	f
CASIE	f
CASIMIRA	f
CASSANDRA	f
CASSAUNDRA	f
CASSEY	f
CASSI	f
CASSIDY	f
CASSIE	f
CASSONDRA	f
CASSY	f
CATALINA	f
CATARINA	f
CATERINA	f
CATHARINE	f
CATHERIN	f
CATHERINA	f
CATHERINE	f
CATHERN	f
CATHERYN	f
CATHEY	f
CATHI	f
CATHIE	f
CATHLEEN	f
CATHRINE	f
CATHRYN	f
CATHY	f
CATINA	f
CATRICE	f
CATRINA	f
CAYLA	f
CECELIA	f
CECIL	m
CECILA	f
CECILE	f
CECILIA	f
CECILLE	f
CECILY	f
CEDRIC	m
CEDRICK	m
CELENA	f
CELESTA	f
CELESTE	f
CELESTINA	f
CELESTINE	f
CELIA	f
CELINA	f
CELINDA	f
CELINE	f
CELSA	f
CEOLA	f
CESAR	m
CHAD	m
CHADWICK	m
CHAE	f
CHAN	f
CHANA	f
CHANCE	m
CHANDA	f
CHANDRA	f
CHANEL	f
CHANELL	f
CHANELLE	f
CHANG	m
CHANTAL	f
CHANTAY	f
CHANTE	f
CHANTEL	f
CHANTELL	f
CHANTELLE	f
CHARA	f
CHARIS	f
CHARISE	f
CHARISSA	f
CHARISSE	f
CHARITA	f
CHARITY	f
CHARLA	f
CHARLEEN	f
CHARLENA	f
CHARLENE	f
CHARLES	m
CHARLESETTA	f
CHARLETTE	f
CHARLEY	m
CHARLIE	m
CHARLINE	f
CHARLOTT	f
CHARLOTTE	f
CHARLSIE	f
CHARLYN	f
CHARMAIN	f
CHARMAINE	f
CHAROLETTE	f
CHAS	m
CHASE	m
CHASIDY	f
CHASITY	f
CHASSIDY	f
CHASTITY	f
CHAU	f
CHAUNCEY	m
CHAYA	f
CHELSEA	f
CHELSEY	f
CHELSIE	f
CHER	f
CHERE	f
CHEREE	f
CHERELLE	f
CHERI	f
CHERIE	f
CHERILYN	f
CHERISE	f
CHERISH	f
CHERLY	f
CHERLYN	f
CHERRI	f
CHERRIE	f
CHERRY	f
CHERRYL	f
CHERY	f
CHERYL	f
CHERYLE	f
CHERYLL	f
CHESTER	m
CHET	m
CHEYENNE	f
CHI	m
CHIA	f
CHIEKO	f
CHIN	f
CHINA	f
CHING	f
CHIQUITA	f
CHLOE	f
CHRIS	m
CHRISSY	f
CHRISTA	f
CHRISTAL	f
CHRISTEEN	f
CHRISTEL	f
CHRISTEN	f
CHRISTENA	f
CHRISTENE	f
CHRISTI	f
CHRISTIA	f
CHRISTIAN	m
CHRISTIANA	f
CHRISTIANE	f
CHRISTIE	f
CHRISTIN	f
CHRISTINA	f
CHRISTINE	f
CHRISTINIA	f
CHRISTOPER	m
CHRISTOPHER	m
CHRISTY	f
CHRYSTAL	f
CHU	f
CHUCK	m
CHUN	f
CHUNG	m
CIARA	f
CICELY	f
CIERA	f
CIERRA	f
CINDA	f
CINDERELLA	f
CINDI	f
CINDIE	f
CINDY	f
CINTHIA	f
CIRA	f
CLAIR	m
CLAIRE	f
CLARA	f
CLARE	f
CLARENCE	m
CLARETHA	f
CLARETTA	f
CLARIBEL	f
CLARICE	f
CLARINDA	f
CLARINE	f
CLARIS	f
CLARISA	f
CLARISSA	f
CLARITA	f
CLARK	m
CLASSIE	f
CLAUD	m
CLAUDE	m
CLAUDETTE	f
CLAUDIA	f
CLAUDIE	f
CLAUDINE	f
CLAUDIO	m
CLAY	m
CLAYTON	m
CLELIA	f
CLEMENCIA	f
CLEMENT	m
CLEMENTE	m
CLEMENTINA	f
CLEMENTINE	f
CLEMMIE	f
CLEO	f
CLEOPATRA	f
CLEORA	f
CLEOTILDE	f
CLETA	f
CLETUS	m
CLEVELAND	m
CLIFF	m
CLIFFORD	m
CLIFTON	m
CLINT	m
CLINTON	m
CLORA	f
CLORINDA	f
CLOTILDE	f
CLYDE	m
CODI	f
CODY	m
COLBY	m
COLE	m
COLEEN	f
COLEMAN	m
COLENE	f
COLETTA	f
COLETTE	f
COLIN	m
COLLEEN	f
COLLEN	f
COLLENE	f
COLLETTE	f
COLLIN	m
COLTON	m
COLUMBUS	m
CONCEPCION	f
CONCEPTION	f
CONCETTA	f
CONCHA	f
CONCHITA	f
CONNIE	f
CONRAD	m
CONSTANCE	f
CONSUELA	f
CONSUELO	f
CONTESSA	f
CORA	f
CORAL	f
CORALEE	f
CORALIE	f
CORAZON	f
CORDELIA	f
CORDELL	m
CORDIA	f
CORDIE	f
COREEN	f
CORENE	f
CORETTA	f
COREY	m
CORI	f
CORIE	f
CORINA	f
CORINE	f
CORINNA	f
CORINNE	f
CORLISS	f
CORNELIA	f
CORNELIUS	m
CORNELL	m
CORRIE	f
CORRIN	f
CORRINA	f
CORRINE	f
CORRINNE	f
CORTEZ	m
CORTNEY	f
CORY	m
COURTNEY	f
COY	m
CRAIG	m
CREOLA	f
CRIS	f
CRISELDA	f
CRISSY	f
CRISTA	f
CRISTAL	f
CRISTEN	f
CRISTI	f
CRISTIE	f
CRISTIN	f
CRISTINA	f
CRISTINE	f
CRISTOBAL	m
CRISTOPHER	m
CRISTY	f
CRYSTA	f
CRYSTAL	f
CRYSTLE	f
CUC	f
CURT	m
CURTIS	m
CYNDI	f
CYNDY	f
CYNTHIA	f
CYRIL	m
CYRSTAL	f
CYRUS	m
CYTHIA	f
DACIA	f
DAGMAR	f
DAGNY	f
DAHLIA	f
DAINA	f
DAINE	f
DAISEY	f
DAISY	f
DAKOTA	f
DALE	m
DALENE	f
DALIA	f
DALILA	f
DALLAS	m
DALTON	m
DAMARIS	f
DAMIAN	m
DAMIEN	m
DAMION	m
DAMON	m
DAN	m
DANA	f
DANAE	f
DANE	m
DANELLE	f
DANETTE	f
DANI	f
DANIA	f
DANIAL	m
DANICA	f
DANIEL	m
DANIELA	f
DANIELE	f
DANIELL	f
DANIELLA	f
DANIELLE	f
DANIKA	f
DANILLE	f
DANILO	m
DANITA	f
DANN	f
DANNA	f
DANNETTE	f
DANNIE	m
DANNIELLE	f
DANNY	m
DANTE	m
DANUTA	f
DANYEL	f
DANYELL	f
DANYELLE	f
DAPHINE	f
DAPHNE	f
DARA	f
DARBY	f
DARCEL	f
DARCEY	f
DARCI	f
DARCIE	f
DARCY	f
DARELL	m
DAREN	m
DARIA	f
DARIN	m
DARIO	m
DARIUS	m
DARLA	f
DARLEEN	f
DARLENA	f
DARLENE	f
DARLINE	f
DARNELL	m
DARON	m
DARREL	m
DARRELL	m
DARREN	m
DARRICK	m
DARRIN	m
DARRON	m
DARRYL	m
DARWIN	m
DARYL	m
DAVE	m
DAVID	m
DAVIDA	f
DAVINA	f
DAVIS	m
DAWN	f
DAWNA	f
DAWNE	f
DAYLE	f
DAYNA	f
DAYSI	f
DEADRA	f
DEAN	m
DEANA	f
DEANDRA	f
DEANDRE	m
DEANDREA	f
DEANE	f
DEANGELO	m
DEANN	f
DEANNA	f
DEANNE	f
DEB	f
DEBBI	f
DEBBIE	f
DEBBRA	f
DEBBY	f
DEBERA	f
DEBI	f
DEBORA	f
DEBORAH	f
DEBRA	f
DEBRAH	f
DEBROAH	f
DEDE	f
DEDRA	f
DEE	f
DEEANN	f
DEEANNA	f
DEEDEE	f
DEEDRA	f
DEENA	f
DEETTA	f
DEIDRA	f
DEIDRE	f
DEIRDRE	f
DEJA	f
DEL	m
DELAINE	f
DELANA	f
DELBERT	m
DELCIE	f
DELENA	f
DELFINA	f
DELIA	f
DELICIA	f
DELILA	f
DELILAH	f
DELINDA	f
DELISA	f
DELL	f
DELLA	f
DELMA	f
DELMAR	m
DELMER	m
DELMY	f
DELOIS	f
DELOISE	f
DELORA	f
DELORAS	f
DELORES	f
DELORIS	f
DELORSE	f
DELPHA	f
DELPHIA	f
DELPHINE	f
DELSIE	f
DELTA	f
DEMARCUS	m
DEMETRA	f
DEMETRIA	f
DEMETRICE	f
DEMETRIUS	m
DENA	f
DENAE	f
DENEEN	f
DENESE	f
DENICE	f
DENIS	m
DENISE	f
DENISHA	f
DENISSE	f
DENITA	f
DENNA	f
DENNIS	m
DENNISE	f
DENNY	m
DENVER	m
DENYSE	f
DEON	m
DEONNA	f
DEREK	m
DERICK	m
DERRICK	m
DESHAWN	m
DESIRAE	f
DESIRE	f
DESIREE	f
DESMOND	m
DESPINA	f
DESSIE	f
DESTINY	f
DETRA	f
DEVIN	m
DEVONA	f
DEVORA	f
DEVORAH	f
DEWAYNE	m
DEWEY	m
DEWITT	m
DEXTER	m
DIA	f
DIAMOND	f
DIAN	f
DIANA	f
DIANE	f
DIANN	f
DIANNA	f
DIANNE	f
DICK	m
DIEDRA	f
DIEDRE	f
DIEGO	m
DIERDRE	f
DIGNA	f
DILLON	m
DIMPLE	f
DINA	f
DINAH	f
DINO	m
DINORAH	f
DION	m
DIONE	f
DIONNA	f
DIONNE	f
DIRK	m
DIVINA	f
DIXIE	f
DODIE	f
DOLLIE	f
DOLLY	f
DOLORES	f
DOLORIS	f
DOMENIC	m
DOMENICA	f
DOMINGA	f
DOMINGO	m
DOMINIC	m
DOMINICA	f
DOMINICK	m
DOMINQUE	f
DOMITILA	f
DOMONIQUE	f
DON	m
DONA	f
DONALD	m
DONELLA	f
DONETTA	f
DONETTE	f
DONG	m
DONITA	f
DONN	m
DONNA	f
DONNELL	m
DONNETTA	f
DONNETTE	f
DONNIE	m
DONNY	m
DONOVAN	m
DONTE	m
DONYA	f
DORA	f
DORATHY	f
DORCAS	f
DOREATHA	f
DOREEN	f
DORENE	f
DORETHA	f
DORETHEA	f
DORETTA	f
DORI	f
DORIA	f
DORIAN	m
DORIE	f
DORINDA	f
DORINE	f
DORIS	f
DORLA	f
DOROTHA	f
DOROTHEA	f
DOROTHY	f
DORRIS	f
DORSEY	m
DORTHA	f
DORTHEA	f
DORTHEY	f
DORTHY	f
DOT	f
DOTTIE	f
DOTTY	f
DOUG	m
DOUGLAS	m
DOUGLASS	m
DOVIE	f
DOYLE	m
DREAMA	f
DREMA	f
DREW	m
DRUCILLA	f
DRUSILLA	f
DUANE	m
DUDLEY	m
DULCE	f
DULCIE	f
DUNCAN	m
DUNG	f
DUSTI	f
DUSTIN	m
DUSTY	m
DWAIN	m
DWANA	f
DWAYNE	m
DWIGHT	m
DYAN	f
DYLAN	m
EARL	m
EARLE	m
EARLEAN	f
EARLEEN	f
EARLENE	f
EARLIE	f
EARLINE	f
EARNEST	m
EARNESTINE	f
EARTHA	f
EASTER	f
EBONI	f
EBONIE	f
EBONY	f
ECHO	f
ED	m
EDA	f
EDDA	f
EDDIE	m
EDDY	m
EDELMIRA	f
EDEN	f
EDGAR	m
EDGARDO	m
EDIE	f
EDISON	m
EDITH	f
EDMOND	m
EDMUND	m
EDMUNDO	m
EDNA	f
EDRA	f
EDRIS	f
EDUARDO	m
EDWARD	m
EDWARDO	m
EDWIN	m
EDWINA	f
EDYTH	f
EDYTHE	f
EFFIE	f
EFRAIN	m
EFREN	m
EHTEL	f
EILEEN	f
EILENE	f
ELA	f
ELADIA	f
ELAINA	f
ELAINE	f
ELANA	f
ELANE	f
ELANOR	f
ELAYNE	f
ELBA	f
ELBERT	m
ELDA	f
ELDEN	m
ELDON	m
ELDORA	f
ELDRIDGE	m
ELEANOR	f
ELEANORA	f
ELEANORE	f
ELEASE	f
ELENA	f
ELENE	f
ELENI	f
ELENOR	f
ELENORA	f
ELENORE	f
ELEONOR	f
ELEONORA	f
ELEONORE	f
ELFREDA	f
ELFRIEDA	f
ELFRIEDE	f
ELI	m
ELIA	f
ELIANA	f
ELIAS	m
ELICIA	f
ELIDA	f
ELIDIA	f
ELIJAH	m
ELIN	f
ELINA	f
ELINOR	f
ELINORE	f
ELISA	f
ELISABETH	f
ELISE	f
ELISEO	m
ELISSA	f
ELIZ	f
ELIZA	f
ELIZABET	f
ELIZABETH	f
ELIZBETH	f
ELIZEBETH	f
ELKE	f
ELLA	f
ELLAMAE	f
ELLAN	f
ELLEN	f
ELLENA	f
ELLI	f
ELLIE	f
ELLIOT	m
ELLIOTT	m
ELLIS	m
ELLSWORTH	m
ELLY	f
ELLYN	f
ELMA	f
ELMER	m
ELMIRA	f
ELMO	m
ELNA	f
ELNORA	f
ELODIA	f
ELOIS	f
ELOISA	f
ELOISE	f
ELOUISE	f
ELOY	m
ELROY	m
ELSA	f
ELSE	f
ELSIE	f
ELSY	f
ELTON	m
ELVA	f
ELVERA	f
ELVIA	f
ELVIE	f
ELVIN	m
ELVINA	f
ELVIRA	f
ELVIS	m
ELWANDA	f
ELWOOD	m
ELYSE	f
ELZA	f
EMA	f
EMANUEL	m
EMELDA	f
EMELIA	f
EMELINA	f
EMELINE	f
EMELY	f
EMERALD	f
EMERITA	f
EMERSON	m
EMERY	m
EMIKO	f
EMIL	m
EMILE	m
EMILEE	f
EMILIA	f
EMILIE	f
EMILIO	m
EMILY	f
EMMA	f
EMMALINE	f
EMMANUEL	m
EMMETT	m
EMMIE	f
EMMITT	m
EMMY	f
EMOGENE	f
EMORY	m
ENA	f
ENDA	f
ENEDINA	f
ENEIDA	f
ENID	f
ENOCH	m
ENOLA	f
ENRIQUE	m
ENRIQUETA	f
EPIFANIA	f
ERA	f
ERASMO	m
ERIC	m
ERICA	f
ERICH	m
ERICK	m
ERICKA	f
ERIK	m
ERIKA	f
ERIN	f
ERINN	f
ERLENE	f
ERLINDA	f
ERLINE	f
ERMA	f
ERMELINDA	f
ERMINIA	f
ERNA	f
ERNEST	m
ERNESTINA	f
ERNESTINE	f
ERNESTO	m
ERNIE	m
ERROL	m
ERVIN	m
ERWIN	m
ERYN	f
ESMERALDA	f
ESPERANZA	f
ESSIE	f
ESTA	f
ESTEBAN	m
ESTEFANA	f
ESTELA	f
ESTELL	f
ESTELLA	f
ESTELLE	f
ESTER	f
ESTHER	f
ESTRELLA	f
ETHA	f
ETHAN	m
ETHEL	f
ETHELENE	f
ETHELYN	f
ETHYL	f
ETSUKO	f
ETTA	f
ETTIE	f
EUFEMIA	f
EUGENA	f
EUGENE	m
EUGENIA	f
EUGENIE	f
EUGENIO	m
EULA	f
EULAH	f
EULALIA	f
EUN	f
EUNA	f
EUNICE	f
EURA	f
EUSEBIA	f
EUSEBIO	m
EUSTOLIA	f
EVA	f
EVALYN	f
EVAN	m
EVANGELINA	f
EVANGELINE	f
EVE	f
EVELIA	f
EVELIN	f
EVELINA	f
EVELINE	f
EVELYN	f
EVELYNE	f
EVELYNN	f
EVERETT	m
EVERETTE	m
EVETTE	f
EVIA	f
EVIE	f
EVITA	f
EVON	f
EVONNE	f
EWA	f
EXIE	f
EZEKIEL	m
EZEQUIEL	m
EZRA	m
FABIAN	m
FABIOLA	f
FAE	f
FAIRY	f
FAITH	f
FALLON	f
FANNIE	f
FANNY	f
FARAH	f
FARRAH	f
FATIMA	f
FATIMAH	f
FAUSTINA	f
FAUSTINO	m
FAUSTO	m
FAVIOLA	f
FAWN	f
FAY	f
FAYE	f
FE	f
FEDERICO	m
FELECIA	f
FELICA	f
FELICE	f
FELICIA	f
FELICIDAD	f
FELICITA	f
FELICITAS	f
FELIPA	f
FELIPE	m
FELISA	f
FELISHA	f
FELIX	m
FELTON	m
FERDINAND	m
FERMIN	m
FERMINA	f
FERN	f
FERNANDA	f
FERNANDE	f
FERNANDO	m
FERNE	f
FIDEL	m
FIDELA	f
FIDELIA	f
FILIBERTO	m
FILOMENA	f
FIONA	f
FLAVIA	f
FLETA	f
FLETCHER	m
FLO	f
FLOR	f
FLORA	f
FLORANCE	f
FLORENCE	f
FLORENCIA	f
FLORENCIO	m
FLORENE	f
FLORENTINA	f
FLORENTINO	m
FLORETTA	f
FLORIA	f
FLORIDA	f
FLORINDA	f
FLORINE	f
FLORRIE	f
FLOSSIE	f
FLOY	f
FLOYD	m
FONDA	f
FOREST	m
FORREST	m
FOSTER	m
FRAN	f
FRANCE	f
FRANCENE	f
FRANCES	f
FRANCESCA	f
FRANCESCO	m
FRANCHESCA	f
FRANCIE	f
FRANCINA	f
FRANCINE	f
FRANCIS	m
FRANCISCA	f
FRANCISCO	m
FRANCOISE	f
FRANK	m
FRANKLIN	m
FRANKLYN	m
FRANSISCA	f
FRED	m
FREDA	f
FREDDA	f
FREDDIE	m
FREDDY	m
FREDERIC	m
FREDERICA	f
FREDERICK	m
FREDERICKA	f
FREDIA	f
FREDRIC	m
FREDRICK	m
FREDRICKA	f
FREEDA	f
FREEMAN	m
FREIDA	f
FRIDA	f
FRIEDA	f
FRITZ	m
FUMIKO	f
GABRIEL	m
GABRIELA	f
GABRIELE	f
GABRIELLA	f
GABRIELLE	f
GAIL	f
GALA	f
GALEN	m
GALINA	f
GARFIELD	m
GARLAND	m
GARNET	f
GARNETT	f
GARRET	m
GARRETT	m
GARRY	m
GARTH	m
GARY	m
GASTON	m
GAVIN	m
GAY	f
GAYE	f
GAYLA	f
GAYLE	f
GAYLENE	f
GAYLORD	m
GAYNELL	f
GAYNELLE	f
GEARLDINE	f
GEMA	f
GEMMA	f
GENA	f
GENARO	m
GENE	m
GENESIS	f
GENEVA	f
GENEVIE	f
GENEVIEVE	f
GENEVIVE	f
GENIA	f
GENIE	f
GENNA	f
GENNIE	f
GENNY	f
GENOVEVA	f
GEOFFREY	m
GEORGANN	f
GEORGE	m
GEORGEANN	f
GEORGEANNA	f
GEORGENE	f
GEORGETTA	f
GEORGETTE	f
GEORGIA	f
GEORGIANA	f
GEORGIANN	f
GEORGIANNA	f
GEORGIANNE	f
GEORGIE	f
GEORGINA	f
GEORGINE	f
GERALD	m
GERALDINE	f
GERALDO	m
GERALYN	f
GERARD	m
GERARDO	m
GERDA	f
GERI	f
GERMAINE	f
GERMAN	m
GERRI	f
GERRY	m
GERTHA	f
GERTIE	f
GERTRUD	f
GERTRUDE	f
GERTRUDIS	f
GERTUDE	f
GHISLAINE	f
GIA	f
GIANNA	f
GIDGET	f
GIGI	f
GIL	m
GILBERT	m
GILBERTE	f
GILBERTO	m
GILDA	f
GILLIAN	f
GILMA	f
GINA	f
GINETTE	f
GINGER	f
GINNY	f
GINO	m
GIOVANNA	f
GIOVANNI	m
GISELA	f
GISELE	f
GISELLE	f
GITA	f
GIUSEPPE	m
GIUSEPPINA	f
GLADIS	f
GLADY	f
GLADYS	f
GLAYDS	f
GLEN	m
GLENDA	f
GLENDORA	f
GLENN	m
GLENNA	f
GLENNIE	f
GLENNIS	f
GLINDA	f
GLORIA	f
GLORY	f
GLYNDA	f
GLYNIS	f
GOLDA	f
GOLDEN	f
GOLDIE	f
GONZALO	m
GORDON	m
GRACE	f
GRACIA	f
GRACIE	f
GRACIELA	f
GRADY	m
GRAHAM	m
GRAIG	m
GRANT	m
GRANVILLE	m
GRAYCE	f
GRAZYNA	f
GREG	m
GREGG	m
GREGORIA	f
GREGORIO	m
GREGORY	m
GRETA	f
GRETCHEN	f
GRETTA	f
GRICELDA	f
GRISEL	f
GRISELDA	f
GROVER	m
GUADALUPE	f
GUDRUN	f
GUILLERMINA	f
GUILLERMO	m
GUS	m
GUSSIE	f
GUSTAVO	m
GUY	m
GWEN	f
GWENDA	f
GWENDOLYN	f
GWENN	f
GWYN	f
GWYNETH	f
HA	f
HAE	f
HAI	m
HAILEY	f
HAL	m
HALEY	f
HALINA	f
HALLEY	f
HALLIE	f
HAN	f
HANA	f
HANG	f
HANH	f
HANK	m
HANNA	f
HANNAH	f
HANNELORE	f
HANS	m
HARLAN	m
HARLAND	m
HARLEY	m
HARMONY	f
HAROLD	m
HARRIET	f
HARRIETT	f
HARRIETTE	f
HARRIS	m
HARRISON	m
HARRY	m
HARVEY	m
HASSAN	m
HASSIE	f
HATTIE	f
HAYDEE	f
HAYDEN	m
HAYLEY	f
HAYWOOD	m
HAZEL	f
HEATH	m
HEATHER	f
HECTOR	m
HEDWIG	f
HEDY	f
HEE	f
HEIDE	f
HEIDI	f
HEIDY	f
HEIKE	f
HELAINE	f
HELEN	f
HELENA	f
HELENE	f
HELGA	f
HELLEN	f
HENRIETTA	f
HENRIETTE	f
HENRY	m
HERB	m
HERBERT	m
HERIBERTO	m
HERLINDA	f
HERMA	f
HERMAN	m
HERMELINDA	f
HERMILA	f
HERMINA	f
HERMINE	f
HERMINIA	f
HERSCHEL	m
HERSHEL	m
HERTA	f
HERTHA	f
HESTER	f
HETTIE	f
HIEDI	f
HIEN	f
HILARIA	f
HILARIO	m
HILARY	f
HILDA	f
HILDE	f
HILDEGARD	f
HILDEGARDE	f
HILDRED	f
HILLARY	f
HILMA	f
HILTON	m
HIPOLITO	m
HIRAM	m
HIROKO	f
HISAKO	f
HOA	f
HOBERT	m
HOLLEY	f
HOLLI	f
HOLLIE	f
HOLLIS	m
HOLLY	f
HOMER	m
HONEY	f
HOPE	f
HORACE	m
HORACIO	m
HORTENCIA	f
HORTENSE	f
HORTENSIA	f
HOSEA	m
HOUSTON	m
HOWARD	m
HOYT	m
HSIU	f
HUBERT	m
HUE	f
HUEY	m
HUGH	m
HUGO	m
HUI	f
HULDA	f
HUMBERTO	m
HUNG	m
HUNTER	m
HUONG	f
HWA	f
HYACINTH	f
HYE	f
HYMAN	m
HYO	f
HYON	f
HYUN	f
IAN	m
IDA	f
IDALIA	f
IDELL	f
IDELLA	f
IESHA	f
IGNACIA	f
IGNACIO	m
IKE	m
ILA	f
ILANA	f
ILDA	f
ILEANA	f
ILEEN	f
ILENE	f
ILIANA	f
ILLA	f
ILONA	f
ILSE	f
ILUMINADA	f
IMA	f
IMELDA	f
IMOGENE	f
IN	f
INA	f
INDIA	f
INDIRA	f
INELL	f
INES	f
INEZ	f
INGA	f
INGE	f
INGEBORG	f
INGER	f
INGRID	f
INOCENCIA	f
IOLA	f
IONA	f
IONE	f
IRA	m
IRAIDA	f
IRENA	f
IRENE	f
IRINA	f
IRIS	f
IRISH	f
IRMA	f
IRMGARD	f
IRVIN	m
IRVING	m
IRWIN	m
ISA	f
ISAAC	m
ISABEL	f
ISABELL	f
ISABELLA	f
ISABELLE	f
ISADORA	f
ISAIAH	m
ISAIAS	m
ISAURA	f
ISELA	f
ISIAH	m
ISIDRA	f
ISIDRO	m
ISIS	f
ISMAEL	m
ISOBEL	f
ISRAEL	m
ISREAL	m
ISSAC	m
IVA	f
IVAN	m
IVANA	f
IVELISSE	f
IVETTE	f
IVEY	f
IVONNE	f
IVY	f
IZETTA	f
IZOLA	f
JA	f
JACALYN	f
JACELYN	f
JACINDA	f
JACINTA	f
JACINTO	m
JACK	m
JACKELINE	f
JACKELYN	f
JACKI	f
JACKIE	f
JACKLYN	f
JACKQUELINE	f
JACKSON	m
JACLYN	f
JACOB	m
JACQUALINE	f
JACQUE	f
JACQUELIN	f
JACQUELINE	f
JACQUELYN	f
JACQUELYNE	f
JACQUELYNN	f
JACQUES	m
JACQUETTA	f
JACQUI	f
JACQUIE	f
JACQUILINE	f
JACQULINE	f
JACQULYN	f
JADA	f
JADE	f
JADWIGA	f
JAIME	m
JAIMEE	f
JAIMIE	f
JAKE	m
JALEESA	f
JALISA	f
JAMA	f
JAMAAL	m
JAMAL	m
JAMAR	m
JAME	m
JAMEE	f
JAMEL	m
JAMES	m
JAMEY	m
JAMI	f
JAMIE	f
JAMIKA	f
JAMILA	f
JAMISON	m
JAMMIE	f
JAN	f
JANA	f
JANAE	f
JANAY	f
JANE	f
JANEAN	f
JANEE	f
JANEEN	f
JANEL	f
JANELL	f
JANELLA	f
JANELLE	f
JANENE	f
JANESSA	f
JANET	f
JANETH	f
JANETT	f
JANETTA	f
JANETTE	f
JANEY	f
JANI	f
JANICE	f
JANIE	f
JANIECE	f
JANINA	f
JANINE	f
JANIS	f
JANISE	f
JANITA	f
JANN	f
JANNA	f
JANNET	f
JANNETTE	f
JANNIE	f
JANUARY	f
JANYCE	f
JAQUELINE	f
JAQUELYN	f
JARED	m
JAROD	m
JARRED	m
JARRETT	m
JARROD	m
JARVIS	m
JASMIN	f
JASMINE	f
JASON	m
JASPER	m
JAUNITA	f
JAVIER	m
JAY	m
JAYE	f
JAYME	f
JAYMIE	f
JAYNA	f
JAYNE	f
JAYSON	m
JAZMIN	f
JAZMINE	f
JC	m
JEAN	f
JEANA	f
JEANE	f
JEANELLE	f
JEANENE	f
JEANETT	f
JEANETTA	f
JEANETTE	f
JEANICE	f
JEANIE	f
JEANINE	f
JEANMARIE	f
JEANNA	f
JEANNE	f
JEANNETTA	f
JEANNETTE	f
JEANNIE	f
JEANNINE	f
JED	m
JEFF	m
JEFFEREY	m
JEFFERSON	m
JEFFERY	m
JEFFIE	f
JEFFREY	m
JEFFRY	m
JEN	f
JENA	f
JENAE	f
JENE	f
JENEE	f
JENELL	f
JENELLE	f
JENETTE	f
JENEVA	f
JENI	f
JENICE	f
JENIFER	f
JENIFFER	f
JENINE	f
JENISE	f
JENNA	f
JENNEFER	f
JENNELL	f
JENNETTE	f
JENNI	f
JENNIE	f
JENNIFER	f
JENNIFFER	f
JENNINE	f
JENNY	f
JERALD	m
JERALDINE	f
JERAMY	m
JERE	m
JEREMIAH	m
JEREMY	m
JERI	f
JERICA	f
JERILYN	f
JERLENE	f
JERMAINE	m
JEROLD	m
JEROME	m
JEROMY	m
JERRELL	m
JERRI	f
JERRICA	f
JERRIE	f
JERROD	m
JERROLD	m
JERRY	m
JESENIA	f
JESICA	f
JESS	m
JESSE	m
JESSENIA	f
JESSI	f
JESSIA	f
JESSICA	f
JESSIKA	f
JESTINE	f
JESUS	m
JESUSA	f
JESUSITA	f
JETTA	f
JETTIE	f
JEWEL	f
JEWELL	f
JI	f
JILL	f
JILLIAN	f
JIM	m
JIMMIE	m
JIMMY	m
JIN	f
JINA	f
JINNY	f
JO	f
JOAN	f
JOANA	f
JOANE	f
JOANIE	f
JOANN	f
JOANNA	f
JOANNE	f
JOANNIE	f
JOAQUIN	m
JOAQUINA	f
JOCELYN	f
JODEE	f
JODI	f
JODIE	f
JOE	m
JOEANN	f
JOEL	m
JOELLA	f
JOELLE	f
JOELLEN	f
JOESPH	m
JOETTA	f
JOETTE	f
JOEY	m
JOHANA	f
JOHANNA	f
JOHANNE	f
JOHN	m
JOHNA	f
JOHNATHAN	m
JOHNATHON	m
JOHNETTA	f
JOHNETTE	f
JOHNIE	m
JOHNNA	f
JOHNNY	m
JOHNSIE	f
JOHNSON	m
JOI	f
JOIE	f
JOLANDA	f
JOLEEN	f
JOLENE	f
JOLIE	f
JOLINE	f
JOLYN	f
JOLYNN	f
JON	m
JONA	f
JONAH	m
JONAS	m
JONATHAN	m
JONATHON	m
JONE	f
JONELL	f
JONELLE	f
JONG	f
JONI	f
JONIE	f
JONNA	f
JONNIE	f
JORDAN	m
JORDON	m
JORGE	m
JOSE	m
JOSEF	m
JOSEFA	f
JOSEFINA	f
JOSEFINE	f
JOSELYN	f
JOSEPH	m
JOSEPHINA	f
JOSEPHINE	f
JOSETTE	f
JOSH	m
JOSHUA	m
JOSIAH	m
JOSIE	f
JOSLYN	f
JOSPEH	m
JOSPHINE	f
JOSUE	m
JOVAN	f
JOVITA	f
JOY	f
JOYA	f
JOYCE	f
JOYCELYN	f
JOYE	f
JUAN	m
JUANA	f
JUANITA	f
JUDE	m
JUDI	f
JUDIE	f
JUDITH	f
JUDSON	m
JUDY	f
JULE	f
JULEE	f
JULENE	f
JULES	m
JULI	f
JULIA	f
JULIAN	m
JULIANA	f
JULIANE	f
JULIANN	f
JULIANNA	f
JULIANNE	f
JULIE	f
JULIEANN	f
JULIENNE	f
JULIET	f
JULIETA	f
JULIETTA	f
JULIETTE	f
JULIO	m
JULISSA	f
JULIUS	m
JUNE	f
JUNG	f
JUNIE	f
JUNIOR	m
JUNITA	f
JUNKO	f
JUSTA	f
JUSTIN	m
JUSTINA	f
JUSTINE	f
JUTTA	f
KA	f
KACEY	f
KACI	f
KACIE	f
KACY	f
KAI	f
KAILA	f
KAITLIN	f
KAITLYN	f
KALA	f
KALEIGH	f
KALEY	f
KALI	f
KALLIE	f
KALYN	f
KAM	f
KAMALA	f
KAMI	f
KAMILAH	f
KANDACE	f
KANDI	f
KANDICE	f
KANDIS	f
KANDRA	f
KANDY	f
KANESHA	f
KANISHA	f
KARA	f
KARAN	f
KAREEM	m
KAREEN	f
KAREN	f
KARENA	f
KAREY	f
KARI	f
KARIE	f
KARIMA	f
KARIN	f
KARINA	f
KARINE	f
KARISA	f
KARISSA	f
KARL	m
KARLA	f
KARLEEN	f
KARLENE	f
KARLY	f
KARLYN	f
KARMA	f
KARMEN	f
KAROL	f
KAROLE	f
KAROLINE	f
KAROLYN	f
KARON	f
KARREN	f
KARRI	f
KARRIE	f
KARRY	f
KARY	f
KARYL	f
KARYN	f
KASANDRA	f
KASEY	f
KASHA	f
KASI	f
KASIE	f
KASSANDRA	f
KASSIE	f
KATE	f
KATELIN	f
KATELYN	f
KATELYNN	f
KATERINE	f
KATHALEEN	f
KATHARINA	f
KATHARINE	f
KATHARYN	f
KATHE	f
KATHELEEN	f
KATHERIN	f
KATHERINA	f
KATHERINE	f
KATHERN	f
KATHERYN	f
KATHEY	f
KATHI	f
KATHIE	f
KATHLEEN	f
KATHLENE	f
KATHLINE	f
KATHLYN	f
KATHRIN	f
KATHRINE	f
KATHRYN	f
KATHRYNE	f
KATHY	f
KATHYRN	f
KATI	f
KATIA	f
KATIE	f
KATINA	f
KATLYN	f
KATRICE	f
KATRINA	f
KATTIE	f
KATY	f
KAY	f
KAYCE	f
KAYCEE	f
KAYE	f
KAYLA	f
KAYLEE	f
KAYLEEN	f
KAYLEIGH	f
KAYLENE	f
KAZUKO	f
KECIA	f
KEELEY	f
KEELY	f
KEENA	f
KEENAN	m
KEESHA	f
KEIKO	f
KEILA	f
KEIRA	f
KEISHA	f
KEITH	m
KEITHA	f
KELI	f
KELLE	f
KELLEE	f
KELLEY	f
KELLI	f
KELLIE	f
KELLY	f
KELLYE	f
KELSEY	f
KELSI	f
KELSIE	f
KELVIN	m
KEMBERLY	f
KEN	m
KENA	f
KENDA	f
KENDAL	f
KENDALL	m
KENDRA	f
KENDRICK	m
KENETH	m
KENIA	f
KENISHA	f
KENNA	f
KENNETH	m
KENNITH	m
KENNY	m
KENT	m
KENTON	m
KENYA	f
KENYATTA	f
KENYETTA	f
KERA	f
KEREN	f
KERI	f
KERMIT	m
KERRI	f
KERRIE	f
KERSTIN	f
KESHA	f
KESHIA	f
KETURAH	f
KEVA	f
KEVEN	m
KEVIN	m
KHADIJAH	f
KHALILAH	f
KIA	f
KIANA	f
KIARA	f
KIERA	f
KIERSTEN	f
KIESHA	f
KIETH	m
KILEY	f
KIM	f
KIMBER	f
KIMBERELY	f
KIMBERLEE	f
KIMBERLEY	f
KIMBERLI	f
KIMBERLIE	f
KIMBERLY	f
KIMBERY	f
KIMBRA	f
KIMI	f
KIMIKO	f
KINA	f
KINDRA	f
KING	m
KIP	m
KIRA	f
KIRBY	m
KIRK	m
KIRSTEN	f
KIRSTIE	f
KIRSTIN	f
KISHA	f
KIT	f
KITTIE	f
KITTY	f
KIYOKO	f
KIZZIE	f
KIZZY	f
KLARA	f
KOREY	m
KORI	f
KORTNEY	f
KORY	m
KOURTNEY	f
KRAIG	m
KRISHNA	f
KRISSY	f
KRISTA	f
KRISTAL	f
KRISTAN	f
KRISTEEN	f
KRISTEL	f
KRISTEN	f
KRISTI	f
KRISTIAN	f
KRISTIE	f
KRISTIN	f
KRISTINA	f
KRISTINE	f
KRISTLE	f
KRISTOFER	m
KRISTOPHER	m
KRISTY	f
KRISTYN	f
KRYSTA	f
KRYSTAL	f
KRYSTEN	f
KRYSTIN	f
KRYSTINA	f
KRYSTLE	f
KRYSTYNA	f
KUM	f
KURT	m
KURTIS	m
KYLA	f
KYLE	m
KYLEE	f
KYLIE	f
KYM	f
KYMBERLY	f
KYOKO	f
KYONG	f
KYRA	f
KYUNG	f
LACEY	f
LACHELLE	f
LACI	f
LACIE	f
LACRESHA	f
LACY	f
LADAWN	f
LADONNA	f
LADY	f
LAEL	f
LAHOMA	f
LAI	f
LAILA	f
LAINE	f
LAJUANA	f
LAKEESHA	f
LAKEISHA	f
LAKENDRA	f
LAKENYA	f
LAKESHA	f
LAKESHIA	f
LAKIA	f
LAKIESHA	f
LAKISHA	f
LAKITA	f
LALA	f
LAMAR	m
LAMONICA	f
LAMONT	m
LAN	f
LANA	f
LANCE	m
LANDON	m
LANE	m
LANELL	f
LANELLE	f
LANETTE	f
LANG	f
LANI	f
LANIE	f
LANITA	f
LANNIE	f
LANNY	m
LANORA	f
LAQUANDA	f
LAQUITA	f
LARA	f
LARAE	f
LARAINE	f
LAREE	f
LARHONDA	f
LARISA	f
LARISSA	f
LARITA	f
LARONDA	f
LARRAINE	f
LARRY	m
LARUE	f
LASANDRA	f
LASHANDA	f
LASHANDRA	f
LASHAUN	f
LASHAUNDA	f
LASHAWN	f
LASHAWNA	f
LASHAWNDA	f
LASHAY	f
LASHELL	f
LASHON	f
LASHONDA	f
LASHUNDA	f
LASONYA	f
LATANYA	f
LATARSHA	f
LATASHA	f
LATASHIA	f
LATESHA	f
LATIA	f
LATICIA	f
LATINA	f
LATISHA	f
LATONIA	f
LATONYA	f
LATORIA	f
LATOSHA	f
LATOYA	f
LATOYIA	f
LATRICE	f
LATRICIA	f
LATRINA	f
LATRISHA	f
LAUNA	f
LAURA	f
LAURALEE	f
LAURAN	f
LAURE	f
LAUREEN	f
LAUREL	f
LAUREN	f
LAURENA	f
LAURENCE	m
LAURENE	f
LAURETTA	f
LAURETTE	f
LAURI	f
LAURICE	f
LAURIE	f
LAURINDA	f
LAURINE	f
LAURYN	f
LAVADA	f
LAVELLE	f
LAVENIA	f
LAVERA	f
LAVERNA	f
LAVERNE	f
LAVETA	f
LAVETTE	f
LAVINA	f
LAVINIA	f
LAVON	f
LAVONA	f
LAVONDA	f
LAVONE	f
LAVONIA	f
LAVONNA	f
LAVONNE	f
LAWANA	f
LAWANDA	f
LAWANNA	f
LAWERENCE	m
LAWRENCE	m
LAYLA	f
LAYNE	f
LAZARO	m
LE	f
LEA	f
LEAH	f
LEAN	f
LEANA	f
LEANDRA	f
LEANDRO	m
LEANN	f
LEANNA	f
LEANNE	f
LEANORA	f
LEATHA	f
LEATRICE	f
LECIA	f
LEDA	f
LEE	m
LEEANN	f
LEEANNA	f
LEEANNE	f
LEENA	f
LEESA	f
LEIA	f
LEIDA	f
LEIF	m
LEIGH	f
LEIGHA	f
LEIGHANN	f
LEILA	f
LEILANI	f
LEISA	f
LEISHA	f
LEKISHA	f
LELA	f
LELAH	f
LELAND	m
LELIA	f
LEMUEL	m
LEN	m
LENA	f
LENARD	m
LENITA	f
LENNA	f
LENNIE	f
LENNY	m
LENORA	f
LENORE	f
LEO	m
LEOLA	f
LEOMA	f
LEON	m
LEONA	f
LEONARD	m
LEONARDA	f
LEONARDO	m
LEONE	f
LEONEL	m
LEONIA	f
LEONIDA	f
LEONIE	f
LEONILA	f
LEONOR	f
LEONORA	f
LEONORE	f
LEONTINE	f
LEOPOLDO	m
LEORA	f
LEOTA	f
LERA	f
LEROY	m
LES	m
LESA	f
LESHA	f
LESIA	f
LESLEE	f
LESLEY	f
LESLI	f
LESSIE	f
LESTER	m
LETA	f
LETHA	f
LETICIA	f
LETISHA	f
LETITIA	f
LETTIE	f
LETTY	f
LEVI	m
LEWIS	m
LEXIE	f
LEZLIE	f
LI	f
LIA	f
LIANA	f
LIANE	f
LIANNE	f
LIBBIE	f
LIBBY	f
LIBERTY	f
LIBRADA	f
LIDA	f
LIDIA	f
LIEN	f
LIESELOTTE	f
LIGIA	f
LILA	f
LILI	f
LILIA	f
LILIAN	f
LILIANA	f
LILLA	f
LILLI	f
LILLIA	f
LILLIAM	f
LILLIAN	f
LILLIANA	f
LILLIE	f
LILLY	f
LILY	f
LIN	f
LINA	f
LINCOLN	m
LINDA	f
LINDSAY	f
LINDSEY	f
LINDSY	f
LINDY	f
LINETTE	f
LING	f
LINH	f
LINN	f
LINNEA	f
LINNIE	f
LINO	m
LINSEY	f
LINWOOD	m
LIONEL	m
LISA	f
LISABETH	f
LISANDRA	f
LISBETH	f
LISE	f
LISETTE	f
LISHA	f
LISSA	f
LISSETTE	f
LITA	f
LIVIA	f
LIZ	f
LIZA	f
LIZABETH	f
LIZBETH	f
LIZETH	f
LIZETTE	f
LIZZETTE	f
LIZZIE	f
LLOYD	m
LOAN	f
LOGAN	m
LOIDA	f
LOIS	f
LOISE	f
LOLA	f
LOLITA	f
LOMA	f
LON	m
LONA	f
LONDA	f
LONG	m
LONI	f
LONNA	f
LONNIE	m
LONNY	m
LORA	f
LORAINE	f
LORALEE	f
LORE	f
LOREAN	f
LOREE	f
LOREEN	f
LORELEI	f
LOREN	m
LORENA	f
LORENE	f
LORENZA	f
LORENZO	m
LORETA	f
LORETTA	f
LORETTE	f
LORI	f
LORIA	f
LORIANN	f
LORIE	f
LORILEE	f
LORINA	f
LORINDA	f
LORINE	f
LORIS	f
LORITA	f
LORNA	f
LORRAINE	f
LORRETTA	f
LORRI	f
LORRIANE	f
LORRIE	f
LORRINE	f
LORY	f
LOTTIE	f
LOU	f
LOUANN	f
LOUANNE	f
LOUELLA	f
LOUETTA	f
LOUIE	m
LOUIS	m
LOUISA	f
LOUISE	f
LOURA	f
LOURDES	f
LOURIE	f
LOUVENIA	f
LOVE	f
LOVELLA	f
LOVETTA	f
LOVIE	f
LOWELL	m
LOYCE	f
LOYD	m
LU	f
LUANA	f
LUANN	f
LUANNA	f
LUANNE	f
LUBA	f
LUCAS	m
LUCI	f
LUCIA	f
LUCIANA	f
LUCIANO	m
LUCIE	f
LUCIEN	m
LUCIENNE	f
LUCILA	f
LUCILE	f
LUCILLA	f
LUCILLE	f
LUCINA	f
LUCINDA	f
LUCIO	m
LUCIUS	m
LUCRECIA	f
LUCRETIA	f
LUCY	f
LUDIE	f
LUDIVINA	f
LUE	f
LUELLA	f
LUETTA	f
LUIGI	m
LUIS	m
LUISA	f
LUISE	f
LUKE	m
LULA	f
LULU	f
LUNA	f
LUPE	f
LUPITA	f
LURA	f
LURLENE	f
LURLINE	f
LUTHER	m
LUVENIA	f
LUZ	f
LYDA	f
LYDIA	f
LYLA	f
LYLE	m
LYMAN	m
LYN	f
LYNDA	f
LYNDIA	f
LYNDON	m
LYNDSAY	f
LYNDSEY	f
LYNELL	f
LYNELLE	f
LYNETTA	f
LYNETTE	f
LYNN	f
LYNNA	f
LYNNE	f
LYNNETTE	f
LYNSEY	f
LYNWOOD	m
MA	f
MABEL	f
MABELLE	f
MABLE	f
MAC	m
MACHELLE	f
MACIE	f
MACK	m
MACKENZIE	f
MACY	f
MADALENE	f
MADALINE	f
MADALYN	f
MADDIE	f
MADELAINE	f
MADELEINE	f
MADELENE	f
MADELINE	f
MADELYN	f
MADGE	f
MADIE	f
MADISON	f
MADLYN	f
MADONNA	f
MAE	f
MAEGAN	f
MAFALDA	f
MAGALI	f
MAGALY	f
MAGAN	f
MAGARET	f
MAGDA	f
MAGDALEN	f
MAGDALENA	f
MAGDALENE	f
MAGEN	f
MAGGIE	f
MAGNOLIA	f
MAHALIA	f
MAI	f
MAIA	f
MAIDA	f
MAILE	f
MAIRA	f
MAIRE	f
MAISHA	f
MAISIE	f
MAJOR	m
MAJORIE	f
MAKEDA	f
MALCOLM	m
MALCOM	m
MALENA	f
MALIA	f
MALIK	m
MALIKA	f
MALINDA	f
MALISA	f
MALISSA	f
MALKA	f
MALLIE	f
MALLORY	f
MALORIE	f
MALVINA	f
MAMIE	f
MAMMIE	f
MAN	m
MANA	f
MANDA	f
MANDI	f
MANDIE	f
MANDY	f
MANIE	f
MANUAL	m
MANUEL	m
MANUELA	f
MANY	f
MAO	f
MAPLE	f
MARA	f
MARAGARET	f
MARAGRET	f
MARANDA	f
MARC	m
MARCEL	m
MARCELA	f
MARCELENE	f
MARCELINA	f
MARCELINE	f
MARCELINO	m
MARCELL	f
MARCELLA	f
MARCELLE	f
MARCELLUS	m
MARCELO	m
MARCENE	f
MARCHELLE	f
MARCI	f
MARCIA	f
MARCIE	f
MARCO	m
MARCOS	m
MARCUS	m
MARCY	f
MARDELL	f
MAREN	f
MARG	f
MARGARET	f
MARGARETA	f
MARGARETE	f
MARGARETT	f
MARGARETTA	f
MARGARETTE	f
MARGARITA	f
MARGARITE	f
MARGARITO	m
MARGART	f
MARGE	f
MARGENE	f
MARGERET	f
MARGERT	f
MARGERY	f
MARGET	f
MARGHERITA	f
MARGIE	f
MARGIT	f
MARGO	f
MARGORIE	f
MARGOT	f
MARGRET	f
MARGRETT	f
MARGUERITA	f
MARGUERITE	f
MARGURITE	f
MARGY	f
MARHTA	f
MARI	f
MARIA	f
MARIAH	f
MARIAM	f
MARIAN	f
MARIANA	f
MARIANELA	f
MARIANN	f
MARIANNA	f
MARIANNE	f
MARIANO	m
MARIBEL	f
MARIBETH	f
MARICA	f
MARICELA	f
MARICRUZ	f
MARIE	f
MARIEL	f
MARIELA	f
MARIELLA	f
MARIELLE	f
MARIETTA	f
MARIETTE	f
MARIKO	f
MARILEE	f
MARILOU	f
MARILU	f
MARILYN	f
MARILYNN	f
MARIN	f
MARINA	f
MARINDA	f
MARINE	f
MARIO	m
MARION	f
MARIS	f
MARISA	f
MARISELA	f
MARISHA	f
MARISOL	f
MARISSA	f
MARITA	f
MARITZA	f
MARIVEL	f
MARJORIE	f
MARJORY	f
MARK	m
MARKETTA	f
MARKITA	f
MARKUS	m
MARLA	f
MARLANA	f
MARLEEN	f
MARLEN	f
MARLENA	f
MARLENE	f
MARLIN	m
MARLINE	f
MARLO	f
MARLON	m
MARLYN	f
MARLYS	f
MARNA	f
MARNI	f
MARNIE	f
MARQUERITE	f
MARQUETTA	f
MARQUIS	m
MARQUITA	f
MARQUITTA	f
MARRY	f
MARSHA	f
MARSHALL	m
MARTA	f
MARTH	f
MARTHA	f
MARTI	f
MARTIN	m
MARTINA	f
MARTINE	f
MARTY	m
MARVA	f
MARVEL	f
MARVELLA	f
MARVIN	m
MARVIS	f
MARX	f
MARY	f
MARYA	f
MARYALICE	f
MARYAM	f
MARYANN	f
MARYANNA	f
MARYANNE	f
MARYBELLE	f
MARYBETH	f
MARYELLEN	f
MARYETTA	f
MARYJANE	f
MARYJO	f
MARYLAND	f
MARYLEE	f
MARYLIN	f
MARYLN	f
MARYLOU	f
MARYLOUISE	f
MARYLYN	f
MARYLYNN	f
MARYROSE	f
MASAKO	f
MASON	m
MATHA	f
MATHEW	m
MATHILDA	f
MATHILDE	f
MATILDA	f
MATILDE	f
MATT	m
MATTHEW	m
MATTIE	f
MAUD	f
MAUDE	f
MAUDIE	f
MAURA	f
MAUREEN	f
MAURICE	m
MAURICIO	m
MAURINE	f
MAURITA	f
MAURO	m
MAVIS	f
MAX	m
MAXIE	f
MAXIMA	f
MAXIMINA	f
MAXIMO	m
MAXINE	f
MAXWELL	m
MAY	f
MAYA	f
MAYBELL	f
MAYBELLE	f
MAYE	f
MAYME	f
MAYNARD	m
MAYOLA	f
MAYRA	f
MAZIE	f
MCKENZIE	f
MCKINLEY	m
MEAGAN	f
MEAGHAN	f
MECHELLE	f
MEDA	f
MEE	f
MEG	f
MEGAN	f
MEGGAN	f
MEGHAN	f
MEGHANN	f
MEI	f
MEL	m
MELAINE	f
MELANI	f
MELANIA	f
MELANIE	f
MELANY	f
MELBA	f
MELDA	f
MELIA	f
MELIDA	f
MELINA	f
MELINDA	f
MELISA	f
MELISSA	f
MELISSIA	f
MELITA	f
MELLIE	f
MELLISA	f
MELLISSA	f
MELODEE	f
MELODI	f
MELODIE	f
MELODY	f
MELONIE	f
MELONY	f
MELVA	f
MELVIN	m
MELVINA	f
MELYNDA	f
MENDY	f
MERCEDES	f
MERCEDEZ	f
MERCY	f
MEREDITH	f
MERI	f
MERIDETH	f
MERIDITH	f
MERILYN	f
MERISSA	f
MERLENE	f
MERLIN	m
MERLYN	f
MERNA	f
MERRI	f
MERRIE	f
MERRILEE	f
MERRILL	m
MERRY	f
MERTIE	f
MERVIN	m
MERYL	f
META	f
MI	f
MIA	f
MICA	f
MICAELA	f
MICAH	m
MICHA	f
MICHAEL	m
MICHAELA	f
MICHAELE	f
MICHALE	m
MICHEAL	m
MICHEL	m
MICHELE	f
MICHELINA	f
MICHELINE	f
MICHELL	f
MICHELLE	f
MICHIKO	f
MICKEY	m
MICKI	f
MICKIE	f
MIESHA	f
MIGDALIA	f
MIGNON	f
MIGUEL	m
MIGUELINA	f
MIKA	f
MIKAELA	f
MIKE	m
MIKEL	m
MIKI	f
MIKKI	f
MILA	f
MILAGRO	f
MILAGROS	f
MILAN	m
MILDA	f
MILDRED	f
MILES	m
MILFORD	m
MILISSA	f
MILLARD	m
MILLICENT	f
MILLIE	f
MILLY	f
MILO	m
MILTON	m
MIMI	f
MIN	f
MINA	f
MINDA	f
MINDI	f
MINDY	f
MINERVA	f
MING	f
MINH	m
MINNA	f
MINNIE	f
MINTA	f
MIQUEL	m
MIRA	f
MIRANDA	f
MIREILLE	f
MIRELLA	f
MIREYA	f
MIRIAM	f
MIRIAN	f
MIRNA	f
MIRTA	f
MIRTHA	f
MISHA	f
MISS	f
MISSY	f
MISTI	f
MISTIE	f
MISTY	f
MITCH	m
MITCHEL	m
MITCHELL	m
MITSUE	f
MITSUKO	f
MITTIE	f
MITZI	f
MITZIE	f
MIYOKO	f
MODESTA	f
MODESTO	m
MOHAMED	m
MOHAMMAD	m
MOHAMMED	m
MOIRA	f
MOISES	m
MOLLIE	f
MOLLY	f
MONA	f
MONET	f
MONICA	f
MONIKA	f
MONIQUE	f
MONNIE	f
MONROE	m
MONSERRATE	f
MONTE	m
MONTY	m
MOON	f
MORA	f
MORIAH	f
MORRIS	m
MORTON	m
MOSE	m
MOSES	m
MOSHE	m
MOZELL	f
MOZELLA	f
MOZELLE	f
MUI	f
MUOI	f
MURIEL	f
MURRAY	m
MY	f
MYESHA	f
MYLES	m
MYONG	f
MYRA	f
MYRIAM	f
MYRL	f
MYRLE	f
MYRNA	f
MYRON	m
MYRTA	f
MYRTICE	f
MYRTIE	f
MYRTIS	f
MYRTLE	f
MYUNG	f
NA	f
NADA	f
NADENE	f
NADIA	f
NADINE	f
NAIDA	f
NAKESHA	f
NAKIA	f
NAKISHA	f
NAKITA	f
NAM	f
NAN	f
NANA	f
NANCEE	f
NANCEY	f
NANCI	f
NANCIE	f
NANCY	f
NANETTE	f
NANNETTE	f
NANNIE	f
NAOMA	f
NAOMI	f
NAPOLEON	m
NARCISA	f
NATACHA	f
NATALIA	f
NATALIE	f
NATALYA	f
NATASHA	f
NATASHIA	f
NATHALIE	f
NATHAN	m
NATHANAEL	m
NATHANIAL	m
NATHANIEL	m
NATISHA	f
NATIVIDAD	f
NATOSHA	f
NEAL	m
NECOLE	f
NED	m
NEDA	f
NEDRA	f
NEELY	f
NEIDA	f
NEIL	m
NELDA	f
NELIA	f
NELIDA	f
NELL	f
NELLA	f
NELLE	f
NELLIE	f
NELLY	f
NELSON	m
NENA	f
NENITA	f
NEOMA	f
NEOMI	f
NEREIDA	f
NERISSA	f
NERY	f
NESTOR	m
NETA	f
NETTIE	f
NEVA	f
NEVADA	f
NEVILLE	m
NEWTON	m
NGA	f
NGAN	f
NGOC	f
NGUYET	f
NIA	f
NICHELLE	f
NICHOL	f
NICHOLAS	m
NICHOLE	f
NICHOLLE	f
NICK	m
NICKI	f
NICKIE	f
NICKOLAS	m
NICKOLE	f
NICOL	f
NICOLA	f
NICOLAS	m
NICOLASA	f
NICOLE	f
NICOLETTE	f
NICOLLE	f
NIDA	f
NIDIA	f
NIESHA	f
NIEVES	f
NIGEL	m
NIKI	f
NIKIA	f
NIKITA	f
NIKKI	f
NIKOLE	f
NILA	f
NILDA	f
NILSA	f
NINA	f
NINFA	f
NISHA	f
NITA	f
NOAH	m
NOBLE	m
NOBUKO	f
NOE	m
NOEL	m
NOELIA	f
NOELLA	f
NOELLE	f
NOEMI	f
NOHEMI	f
NOLA	f
NOLAN	m
NOMA	f
NONA	f
NORA	f
NORAH	f
NORBERT	m
NORBERTO	m
NOREEN	f
NORENE	f
NORIKO	f
NORINE	f
NORMA	f
NORMAN	m
NORMAND	m
NORRIS	m
NOVA	f
NOVELLA	f
NU	f
NUBIA	f
NUMBERS	m
NYDIA	f
NYLA	f
OBDULIA	f
OCIE	f
OCTAVIA	f
OCTAVIO	m
ODA	f
ODELIA	f
ODELL	m
ODESSA	f
ODETTE	f
ODILIA	f
ODIS	m
OFELIA	f
OK	f
OLA	f
OLEN	m
OLENE	f
OLETA	f
OLEVIA	f
OLGA	f
OLIMPIA	f
OLIN	m
OLINDA	f
OLIVA	f
OLIVE	f
OLIVER	m
OLIVIA	f
OLLIE	f
OLYMPIA	f
OMA	f
OMAR	m
OMEGA	f
OMER	m
ONA	f
ONEIDA	f
ONIE	f
ONITA	f
OPAL	f
OPHELIA	f
ORA	f
ORALEE	f
ORALIA	f
OREN	m
ORETHA	f
ORLANDO	m
ORPHA	f
ORVAL	m
ORVILLE	m
OSCAR	m
OSSIE	f
OSVALDO	m
OSWALDO	m
OTELIA	f
OTHA	m
OTILIA	f
OTIS	m
OTTO	m
OUIDA	f
OWEN	m
OZELL	f
OZELLA	f
OZIE	f
PA	f
PABLO	m
PAGE	f
PAIGE	f
PALMA	f
PALMER	m
PALMIRA	f
PAM	f
PAMALA	f
PAMELA	f
PAMELIA	f
PAMELLA	f
PAMILA	f
PAMULA	f
PANDORA	f
PANSY	f
PAOLA	f
PARKER	m
PARTHENIA	f
PARTICIA	f
PASQUALE	m
PASTY	f
PATIENCE	f
PATRIA	f
PATRICA	f
PATRICE	f
PATRICIA	f
PATRICK	m
PATRINA	f
PATSY	f
PATTI	f
PATTIE	f
PATTY	f
PAUL	m
PAULA	f
PAULENE	f
PAULETTA	f
PAULETTE	f
PAULINA	f
PAULINE	f
PAULITA	f
PAZ	f
PEARL	f
PEARLE	f
PEARLENE	f
PEARLIE	f
PEARLINE	f
PEARLY	f
PEDRO	m
PEG	f
PEGGIE	f
PEGGY	f
PEI	f
PENELOPE	f
PENNEY	f
PENNI	f
PENNIE	f
PENNY	f
PERCY	m
PERLA	f
PERRY	m
PETE	m
PETER	m
PETRA	f
PETRINA	f
PETRONILA	f
PHEBE	f
PHIL	m
PHILIP	m
PHILLIP	m
PHILLIS	f
PHILOMENA	f
PHOEBE	f
PHUNG	f
PHUONG	f
PHYLICIA	f
PHYLIS	f
PHYLISS	f
PHYLLIS	f
PIA	f
PIEDAD	f
PIERRE	m
PILAR	f
PING	f
PINKIE	f
PIPER	f
POK	f
POLLY	f
PORFIRIO	m
PORSCHE	f
PORSHA	f
PORTER	m
PORTIA	f
PRECIOUS	f
PRESTON	m
PRICILLA	f
PRINCE	m
PRINCESS	f
PRISCILA	f
PRISCILLA	f
PROVIDENCIA	f
PRUDENCE	f
PURA	f
QIANA	f
QUEEN	f
QUEENIE	f
QUENTIN	m
QUIANA	f
QUINCY	m
QUINN	m
QUINTIN	m
QUINTON	m
QUYEN	f
RACHAEL	f
RACHAL	f
RACHEAL	f
RACHEL	f
RACHELE	f
RACHELL	f
RACHELLE	f
RACQUEL	f
RAE	f
RAEANN	f
RAELENE	f
RAFAEL	m
RAFAELA	f
RAGUEL	f
RAINA	f
RAISA	f
RALEIGH	m
RALPH	m
RAMIRO	m
RAMON	m
RAMONA	f
RAMONITA	f
RANA	f
RANAE	f
RANDA	f
RANDAL	m
RANDALL	m
RANDEE	f
RANDELL	m
RANDI	f
RANDOLPH	m
RANDY	m
RANEE	f
RAPHAEL	m
RAQUEL	f
RASHAD	m
RASHEEDA	f
RASHIDA	f
RAUL	m
RAVEN	f
RAY	m
RAYE	f
RAYFORD	m
RAYLENE	f
RAYMON	m
RAYMOND	m
RAYMONDE	f
RAYMUNDO	m
RAYNA	f
REA	f
REAGAN	f
REANNA	f
REATHA	f
REBA	f
REBBECA	f
REBBECCA	f
REBECA	f
REBECCA	f
REBECKA	f
REBEKAH	f
REDA	f
REED	m
REENA	f
REFUGIA	f
REFUGIO	m
REGAN	f
REGENA	f
REGENIA	f
REGGIE	m
REGINA	f
REGINALD	m
REGINE	f
REGINIA	f
REID	m
REIKO	f
REINA	f
REINALDO	m
REITA	f
REMA	f
REMEDIOS	f
REMONA	f
RENA	f
RENAE	f
RENALDO	m
RENATA	f
RENATE	f
RENATO	m
RENAY	f
RENDA	f
RENE	m
RENEA	f
RENEE	f
RENETTA	f
RENITA	f
RENNA	f
RESSIE	f
RETA	f
RETHA	f
RETTA	f
REUBEN	m
REVA	f
REX	m
REY	m
REYES	m
REYNA	f
REYNALDA	f
REYNALDO	m
RHEA	f
RHEBA	f
RHETT	m
RHIANNON	f
RHODA	f
RHONA	f
RHONDA	f
RIA	f
RICARDA	f
RICARDO	m
RICH	m
RICHARD	m
RICHELLE	f
RICHIE	m
RICK	m
RICKEY	m
RICKI	f
RICKIE	m
RICKY	m
RICO	m
RIGOBERTO	m
RIKKI	f
RILEY	m
RIMA	f
RINA	f
RISA	f
RITA	f
RIVA	f
RIVKA	f
ROB	m
ROBBI	f
ROBBIN	f
ROBBY	m
ROBBYN	f
ROBENA	f
ROBERT	m
ROBERTA	f
ROBERTO	m
ROBIN	f
ROBT	m
ROBYN	f
ROCCO	m
ROCHEL	f
ROCHELL	f
ROCHELLE	f
ROCIO	f
ROCKY	m
ROD	m
RODERICK	m
RODGER	m
RODNEY	m
RODOLFO	m
RODRICK	m
RODRIGO	m
ROGELIO	m
ROGER	m
ROLAND	m
ROLANDA	f
ROLANDE	f
ROLANDO	m
ROLF	m
ROLLAND	m
ROMA	f
ROMAINE	f
ROMAN	m
ROMANA	f
ROMELIA	f
ROMEO	m
ROMONA	f
RON	m
RONA	f
RONALD	m
RONDA	f
RONI	f
RONNA	f
RONNI	f
RONNIE	m
RONNY	m
ROOSEVELT	m
RORY	m
ROSA	f
ROSALBA	f
ROSALEE	f
ROSALIA	f
ROSALIE	f
ROSALINA	f
ROSALIND	f
ROSALINDA	f
ROSALINE	f
ROSALVA	f
ROSALYN	f
ROSAMARIA	f
ROSAMOND	f
ROSANA	f
ROSANN	f
ROSANNA	f
ROSANNE	f
ROSARIA	f
ROSARIO	f
ROSAURA	f
ROSCOE	m
ROSE	f
ROSEANN	f
ROSEANNA	f
ROSEANNE	f
ROSELEE	f
ROSELIA	f
ROSELINE	f
ROSELLA	f
ROSELLE	f
ROSELYN	f
ROSEMARIE	f
ROSEMARY	f
ROSENA	f
ROSENDA	f
ROSENDO	m
ROSETTA	f
ROSETTE	f
ROSIA	f
ROSIE	f
ROSINA	f
ROSIO	f
ROSITA	f
ROSLYN	f
ROSS	m
ROSSANA	f
ROSSIE	f
ROSY	f
ROWENA	f
ROXANA	f
ROXANE	f
ROXANN	f
ROXANNA	f
ROXANNE	f
ROXIE	f
ROXY	f
ROY	m
ROYAL	m
ROYCE	m
ROZANNE	f
ROZELLA	f
RUBEN	m
RUBI	f
RUBIE	f
RUBIN	m
RUBY	f
RUBYE	f
RUDOLF	m
RUDOLPH	m
RUDY	m
RUEBEN	m
RUFINA	f
RUFUS	m
RUPERT	m
RUSS	m
RUSSEL	m
RUSSELL	m
RUSTY	m
RUTH	f
RUTHA	f
RUTHANN	f
RUTHANNE	f
RUTHE	f
RUTHIE	f
RYAN	m
RYANN	f
SABINA	f
SABINE	f
SABRA	f
SABRINA	f
SACHA	f
SACHIKO	f
SADE	f
SADIE	f
SADYE	f
SAGE	f
SAL	m
SALENA	f
SALINA	f
SALLEY	f
SALLIE	f
SALLY	f
SALOME	f
SALVADOR	m
SALVATORE	m
SAM	m
SAMANTHA	f
SAMARA	f
SAMATHA	f
SAMELLA	f
SAMIRA	f
SAMMIE	m
SAMMY	m
SAMUAL	m
SAMUEL	m
SANA	f
SANDA	f
SANDEE	f
SANDI	f
SANDIE	f
SANDRA	f
SANDY	f
SANFORD	m
SANG	m
SANJUANA	f
SANJUANITA	f
SANORA	f
SANTA	f
SANTANA	f
SANTIAGO	m
SANTINA	f
SANTO	m
SANTOS	m
SARA	f
SARAH	f
SARAI	f
SARAN	f
SARI	f
SARINA	f
SARITA	f
SASHA	f
SATURNINA	f
SAU	f
SAUL	m
SAUNDRA	f
SAVANNA	f
SAVANNAH	f
SCARLET	f
SCARLETT	f
SCOT	m
SCOTT	m
SCOTTIE	m
SCOTTY	m
SEAN	m
SEASON	f
SEBASTIAN	m
SEBRINA	f
SEE	f
SEEMA	f
SELENA	f
SELENE	f
SELINA	f
SELMA	f
SENA	f
SENAIDA	f
SEPTEMBER	f
SERAFINA	f
SERENA	f
SERGIO	m
SERINA	f
SERITA	f
SETH	m
SETSUKO	f
SEYMOUR	m
SHA	f
SHAD	m
SHAE	f
SHAINA	f
SHAKIA	f
SHAKIRA	f
SHAKITA	f
SHALA	f
SHALANDA	f
SHALON	f
SHALONDA	f
SHAMEKA	f
SHAMIKA	f
SHAN	f
SHANA	f
SHANAE	f
SHANDA	f
SHANDI	f
SHANDRA	f
SHANE	m
SHANEKA	f
SHANEL	f
SHANELL	f
SHANELLE	f
SHANI	f
SHANICE	f
SHANIKA	f
SHANIQUA	f
SHANITA	f
SHANNA	f
SHANNAN	f
SHANNON	f
SHANON	f
SHANTA	f
SHANTAE	f
SHANTAY	f
SHANTE	f
SHANTEL	f
SHANTELL	f
SHANTELLE	f
SHANTI	f
SHAQUANA	f
SHAQUITA	f
SHARA	f
SHARAN	f
SHARDA	f
SHAREE	f
SHARELL	f
SHAREN	f
SHARI	f
SHARICE	f
SHARIE	f
SHARIKA	f
SHARILYN	f
SHARITA	f
SHARLA	f
SHARLEEN	f
SHARLENE	f
SHARMAINE	f
SHAROLYN	f
SHARON	f
SHARONDA	f
SHARRI	f
SHARRON	f
SHARYL	f
SHARYN	f
SHASTA	f
SHAUN	m
SHAUNA	f
SHAUNDA	f
SHAUNNA	f
SHAUNTA	f
SHAUNTE	f
SHAVON	f
SHAVONDA	f
SHAVONNE	f
SHAWANA	f
SHAWANDA	f
SHAWANNA	f
SHAWN	m
SHAWNA	f
SHAWNDA	f
SHAWNEE	f
SHAWNNA	f
SHAWNTA	f
SHAY	f
SHAYLA	f
SHAYNA	f
SHAYNE	m
SHEA	f
SHEBA	f
SHEENA	f
SHEILA	f
SHEILAH	f
SHELA	f
SHELBA	f
SHELBY	f
SHELDON	m
SHELIA	f
SHELLA	f
SHELLEY	f
SHELLI	f
SHELLIE	f
SHELLY	f
SHELTON	m
SHEMEKA	f
SHEMIKA	f
SHENA	f
SHENIKA	f
SHENITA	f
SHENNA	f
SHERA	f
SHEREE	f
SHERELL	f
SHERI	f
SHERICE	f
SHERIDAN	f
SHERIE	f
SHERIKA	f
SHERILL	f
SHERILYN	f
SHERISE	f
SHERITA	f
SHERLENE	f
SHERLEY	f
SHERLY	f
SHERLYN	f
SHERMAN	m
SHERON	f
SHERRELL	f
SHERRI	f
SHERRIE	f
SHERRIL	f
SHERRILL	f
SHERRON	f
SHERRY	f
SHERRYL	f
SHERWOOD	m
SHERY	f
SHERYL	f
SHERYLL	f
SHIELA	f
SHILA	f
SHILOH	f
SHIN	f
SHIRA	f
SHIRELY	f
SHIRL	f
SHIRLEE	f
SHIRLEEN	f
SHIRLENE	f
SHIRLEY	f
SHIRLY	f
SHIZUE	f
SHIZUKO	f
SHON	m
SHONA	f
SHONDA	f
SHONDRA	f
SHONNA	f
SHONTA	f
SHOSHANA	f
SHU	f
SHYLA	f
SIBYL	f
SID	m
SIDNEY	m
SIERRA	f
SIGNE	f
SIGRID	f
SILAS	m
SILVA	f
SILVANA	f
SILVIA	f
SIMA	f
SIMON	m
SIMONA	f
SIMONE	f
SIMONNE	f
SINA	f
SINDY	f
SIOBHAN	f
SIRENA	f
SIU	f
SIXTA	f
SKYE	f
SLYVIA	f
SO	f
SOCORRO	f
SOFIA	f
SOILA	f
SOL	m
SOLANGE	f
SOLEDAD	f
SOLOMON	m
SOMER	f
SOMMER	f
SON	m
SONA	f
SONDRA	f
SONG	f
SONIA	f
SONJA	f
SONNY	m
SONYA	f
SOO	f
SOOK	f
SOON	f
SOPHIA	f
SOPHIE	f
SORAYA	f
SPARKLE	f
SPENCER	m
SPRING	f
STACEE	f
STACEY	f
STACI	f
STACIA	f
STACIE	f
STACY	f
STAN	m
STANFORD	m
STANLEY	m
STANTON	m
STAR	f
STARLA	f
STARR	f
STASIA	f
STEFAN	m
STEFANI	f
STEFANIA	f
STEFANIE	f
STEFANY	f
STEFFANIE	f
STELLA	f
STEPANIE	f
STEPHAINE	f
STEPHAN	m
STEPHANE	f
STEPHANI	f
STEPHANIA	f
STEPHANIE	f
STEPHANY	f
STEPHEN	m
STEPHENIE	f
STEPHINE	f
STEPHNIE	f
STERLING	m
STEVE	m
STEVEN	m
STEVIE	m
STEWART	m
STORMY	f
STUART	m
SU	f
SUANNE	f
SUDIE	f
SUE	f
SUEANN	f
SUELLEN	f
SUK	f
SULEMA	f
SUMIKO	f
SUMMER	f
SUN	f
SUNDAY	f
SUNG	m
SUNNI	f
SUNNY	f
SUNSHINE	f
SUSAN	f
SUSANA	f
SUSANN	f
SUSANNA	f
SUSANNAH	f
SUSANNE	f
SUSIE	f
SUSY	f
SUZAN	f
SUZANN	f
SUZANNA	f
SUZANNE	f
SUZETTE	f
SUZI	f
SUZIE	f
SUZY	f
SVETLANA	f
SYBIL	f
SYBLE	f
SYLVESTER	m
SYLVIA	f
SYLVIE	f
SYNTHIA	f
SYREETA	f
TA	f
TABATHA	f
TABETHA	f
TABITHA	f
TAD	m
TAI	f
TAINA	f
TAISHA	f
TAJUANA	f
TAKAKO	f
TAKISHA	f
TALIA	f
TALISHA	f
TALITHA	f
TAM	f
TAMA	f
TAMALA	f
TAMAR	f
TAMARA	f
TAMATHA	f
TAMBRA	f
TAMEIKA	f
TAMEKA	f
TAMEKIA	f
TAMELA	f
TAMERA	f
TAMESHA	f
TAMI	f
TAMICA	f
TAMIE	f
TAMIKA	f
TAMIKO	f
TAMISHA	f
TAMMARA	f
TAMMERA	f
TAMMI	f
TAMMIE	f
TAMMY	f
TAMRA	f
TANA	f
TANDRA	f
TANDY	f
TANEKA	f
TANESHA	f
TANGELA	f
TANIA	f
TANIKA	f
TANISHA	f
TANJA	f
TANNA	f
TANNER	m
TANYA	f
TARA	f
TARAH	f
TAREN	f
TARI	f
TARRA	f
TARSHA	f
TARYN	f
TASHA	f
TASHIA	f
TASHINA	f
TASIA	f
TATIANA	f
TATUM	f
TATYANA	f
TAUNYA	f
TAWANA	f
TAWANDA	f
TAWANNA	f
TAWNA	f
TAWNY	f
TAWNYA	f
TAYNA	f
TED	m
TEDDY	m
TEENA	f
TEGAN	f
TEISHA	f
TELMA	f
TEMEKA	f
TEMIKA	f
TEMPIE	f
TEMPLE	f
TENA	f
TENESHA	f
TENISHA	f
TENNIE	f
TENNILLE	f
TEODORA	f
TEODORO	m
TEOFILA	f
TEQUILA	f
TERA	f
TEREASA	f
TERENCE	m
TERESA	f
TERESE	f
TERESIA	f
TERESITA	f
TERESSA	f
TERI	f
TERICA	f
TERINA	f
TERISA	f
TERRA	f
TERRANCE	m
TERRELL	m
TERRENCE	m
TERRESA	f
TERRI	f
TERRIE	f
TERRILYN	f
TERRY	m
TESHA	f
TESS	f
TESSA	f
TESSIE	f
THAD	m
THADDEUS	m
THALIA	f
THANH	m
THAO	f
THEA	f
THEDA	f
THELMA	f
THEO	m
THEODORA	f
THEODORE	m
THEOLA	f
THERESA	f
THERESE	f
THERESIA	f
THERESSA	f
THERON	m
THERSA	f
THI	f
THOMAS	m
THOMASENA	f
THOMASINA	f
THOMASINE	f
THORA	f
THRESA	f
THU	f
THURMAN	m
THUY	f
TIA	f
TIANA	f
TIANNA	f
TIARA	f
TIEN	f
TIERA	f
TIERRA	f
TIESHA	f
TIFANY	f
TIFFANEY	f
TIFFANI	f
TIFFANIE	f
TIFFANY	f
TIFFINY	f
TIJUANA	f
TILDA	f
TILLIE	f
TIM	m
TIMIKA	f
TIMMY	m
TIMOTHY	m
TINA	f
TINISHA	f
TINY	f
TISA	f
TISH	f
TISHA	f
TITUS	m
TOBI	f
TOBIAS	m
TOBIE	f
TOBY	m
TOCCARA	f
TOD	m
TODD	m
TOI	f
TOM	m
TOMAS	m
TOMASA	f
TOMEKA	f
TOMI	f
TOMIKA	f
TOMIKO	f
TOMMY	m
TOMMYE	f
TOMOKO	f
TONA	f
TONDA	f
TONETTE	f
TONEY	m
TONI	f
TONIA	f
TONIE	f
TONISHA	f
TONITA	f
TONJA	f
TONY	m
TONYA	f
TORA	f
TORI	f
TORIE	f
TORRI	f
TORRIE	f
TORY	m
TOSHA	f
TOSHIA	f
TOSHIKO	f
TOVA	f
TOWANDA	f
TOYA	f
TRACEE	f
TRACEY	f
TRACI	f
TRACIE	f
TRACY	f
TRAN	f
TRANG	f
TRAVIS	m
TREASA	f
TREENA	f
TRENA	f
TRENT	m
TRENTON	m
TRESA	f
TRESSA	f
TRESSIE	f
TREVA	f
TREVOR	m
TREY	m
TRICIA	f
TRINA	f
TRINH	f
TRINITY	f
TRISH	f
TRISHA	f
TRISTA	f
TRISTAN	m
TROY	m
TRUDI	f
TRUDIE	f
TRUDY	f
TRULA	f
TRUMAN	m
TU	f
TUAN	m
TULA	f
TUYET	f
TWANA	f
TWANDA	f
TWANNA	f
TWILA	f
TWYLA	f
TY	m
TYESHA	f
TYISHA	f
TYLER	m
TYNISHA	f
TYRA	f
TYREE	m
TYRELL	m
TYRON	m
TYRONE	m
TYSON	m
ULA	f
ULRIKE	f
ULYSSES	m
UN	f
UNA	f
URSULA	f
USHA	f
UTE	f
VADA	f
VALARIE	f
VALDA	f
VALENCIA	f
VALENE	f
VALENTIN	m
VALENTINA	f
VALENTINE	m
VALERI	f
VALERIA	f
VALERIE	f
VALERY	f
VALLIE	f
VALORIE	f
VALRIE	f
VAN	m
VANCE	m
VANDA	f
VANESA	f
VANESSA	f
VANETTA	f
VANIA	f
VANITA	f
VANNA	f
VANNESA	f
VANNESSA	f
VASHTI	f
VASILIKI	f
VAUGHN	m
VEDA	f
VELDA	f
VELIA	f
VELLA	f
VELMA	f
VELVA	f
VELVET	f
VENA	f
VENESSA	f
VENETTA	f
VENICE	f
VENITA	f
VENNIE	f
VENUS	f
VEOLA	f
VERA	f
VERDA	f
VERDELL	f
VERDIE	f
VERENA	f
VERGIE	f
VERLA	f
VERLENE	f
VERLIE	f
VERLINE	f
VERN	m
VERNA	f
VERNELL	f
VERNETTA	f
VERNIA	f
VERNICE	f
VERNIE	f
VERNITA	f
VERNON	m
VERONA	f
VERONICA	f
VERONIKA	f
VERONIQUE	f
VERSIE	f
VERTIE	f
VESTA	f
VETA	f
VI	f
VICENTA	f
VICENTE	m
VICKEY	f
VICKI	f
VICKIE	f
VICKY	f
VICTOR	m
VICTORIA	f
VICTORINA	f
VIDA	f
VIKI	f
VIKKI	f
VILMA	f
VINA	f
VINCE	m
VINCENT	m
VINCENZA	f
VINCENZO	m
VINITA	f
VINNIE	f
VIOLA	f
VIOLET	f
VIOLETA	f
VIOLETTE	f
VIRGEN	f
VIRGIE	f
VIRGIL	m
VIRGILIO	m
VIRGINA	f
VIRGINIA	f
VITA	f
VITO	m
VIVA	f
VIVAN	f
VIVIAN	f
VIVIANA	f
VIVIEN	f
VIVIENNE	f
VON	m
VONCILE	f
VONDA	f
VONNIE	f
WADE	m
WAI	f
WALDO	m
WALKER	m
WALLACE	m
WALLY	m
WALTER	m
WALTON	m
WALTRAUD	f
WAN	f
WANDA	f
WANETA	f
WANETTA	f
WANITA	f
WARD	m
WARNER	m
WARREN	m
WAVA	f
WAYLON	m
WAYNE	m
WEI	f
WELDON	m
WEN	f
WENDELL	m
WENDI	f
WENDIE	f
WENDOLYN	f
WENDY	f
WENONA	f
WERNER	m
WES	m
WESLEY	m
WESTON	m
WHITLEY	f
WHITNEY	f
WILBER	m
WILBERT	m
WILBUR	m
WILBURN	m
WILDA	f
WILEY	m
WILFORD	m
WILFRED	m
WILFREDO	m
WILHELMINA	f
WILHEMINA	f
WILL	m
WILLA	f
WILLARD	m
WILLENA	f
WILLENE	f
WILLETTA	f
WILLETTE	f
WILLIA	f
WILLIAM	m
WILLIAMS	m
WILLIAN	m
WILLIE	m
WILLIEMAE	f
WILLIS	m
WILLODEAN	f
WILLOW	f
WILLY	m
WILMA	f
WILMER	m
WILSON	m
WILTON	m
WINDY	f
WINFORD	m
WINFRED	m
WINIFRED	f
WINNIE	f
WINNIFRED	f
WINONA	f
WINSTON	m
WINTER	f
WM	m
WONDA	f
WOODROW	m
WYATT	m
WYNELL	f
WYNONA	f
XAVIER	m
XENIA	f
XIAO	f
XIOMARA	f
XOCHITL	f
XUAN	f
YADIRA	f
YAEKO	f
YAEL	f
YAHAIRA	f
YAJAIRA	f
YAN	f
YANG	f
YANIRA	f
YASMIN	f
YASMINE	f
YASUKO	f
YEE	f
YELENA	f
YEN	f
YER	f
YESENIA	f
YESSENIA	f
YETTA	f
YEVETTE	f
YI	f
YING	f
YOKO	f
YOLANDA	f
YOLANDE	f
YOLANDO	f
YOLONDA	f
YON	f
YOSHIE	f
YOSHIKO	f
YOULANDA	f
YU	f
YUETTE	f
YUK	f
YUKI	f
YUKIKO	f
YUKO	f
YULANDA	f
YUN	f
YUNG	f
YUONNE	f
YURI	f
YURIKO	f
YVETTE	f
YVONE	f
YVONNE	f
ZACHARIAH	m
ZACHARY	m
ZACHERY	m
ZACK	m
ZACKARY	m
ZADA	f
ZAIDA	f
ZANA	f
ZANDRA	f
ZANE	m
ZELDA	f
ZELLA	f
ZELMA	f
ZENA	f
ZENAIDA	f
ZENIA	f
ZENOBIA	f
ZETTA	f
ZINA	f
ZITA	f
ZOE	f
ZOFIA	f
ZOILA	f
ZOLA	f
ZONA	f
ZONIA	f
ZORA	f
ZORAIDA	f
ZULA	f
ZULEMA	f
ZULMA	f
